10123
1122111112
1121111212
1211111211
2122121212
1111111121
1211211111
1111111112
1111121212
1121112112
2122111121
