100.ox
..o.........o.o..o....o.................o....oooo..o............o...o......o..o.................o...
o....oo.oo......o..o.o..o..oo..o.....o.................o....o.......o.o........o.o..o..ooo.o....o..o
.ooo..ooo...o..o.....oo.....o..o...o..........oo..........o....o...........o.oo.o.o....o..o....o....
...o....o.oo..o....o.......o..o....o.oo.....o.o...o..o..o.oo..o..o........o.oo...o..................
..o.o.o..........o......o..........o.o.........o....o.........o.oo.......oo..o....o........o...o....
o..oo...o.............o....o....o..oo..o.o..o......oo.o...oo.....oo.ooo........o.oo.o...o.o...o..o..
......o..ooooo.....oo.....o...o.o...oo.........o............o.......o.....o...o..o.o....o...........
o.o......oo...o..oo.o.....o.o........o..o...........o..........oo...o..o.o..o..........oo.o..oo.....
....oo.o.........o..o..o...o.....o.oo...o..oo......o..o.oo..........o...o.o...oo.......o.........ooo
..o.....oo...........o....o...o..oooo.o.o.....o.o..o..o..o....o....oooo.....oo.o............o.......
...oo.....o.o...o........o....oo...o.o.o...o..............ooo.o....o............ooo..........o.o..o.
...o..o.....o.o.o.o.o.........o..oooo..ooo.o.o.o....o.........oo.....ooo...o.oo...o.................
.o..o.o....o..........o....o.o........oo...o.............o...oo.....ooo..oo..o.....o..o.............
......o......o..........o.oo..o.o..oo....oo..o....oo......oo.o....o..o..o.o.o..............o....o...
oo..o...o.o........o...o....o.o..........oooo...ooo....o...o..ooo....o...o..........o...o....o....o.
..o.oo..o.o.oo......o...o.o..oo.......o........o..o......o.......o...o.oo.........o.o...o....o...o..
ooo...........o.o....o.o..o..o.o...o.............o.o..o...o.....o.o.ooo....oo.........o.o.o..oo..o.o
.........o...o.....ooooo.......o.o...ooo..oo...o.ooo....oo...o...o..o.....o....o.oo...........o.....
....o....o.....o.....o....o.o.o..o...oo..o........o.o.o...o..o.....o....oo......oo..........o..o.o..
oo...o..........oo.............o....o...o.oo...o.....o........o.......oo.o...oo.o...........o.o.....
.......o.o.....o...o............o....o..o..o...o....o...o......o.o.o.o........o....ooo.......o.....o
.....oo.o.o............oo.o.o..o..o.....o...ooo..o..oo.o...oooo....o..o..oo......o..o..o....o.....o.
o......o.oo....oo....o....o....................o...o......o.......o.oo..o.o............oo..oo....o..
.....o...o.o.o.....o..o...o.......o........o..oooo.o.oo..o...ooo..o...o..o.......o............oo....
....o...o.......o.....o..oo..o.o..o........o.oo..o....o...............o.o.o.oo.....o....o..o.o..o.oo
.o....oo.o.oo...o......o....o......o.o..o.o.o..o.o...o.o....o....oo...........oo.......o............
.......o.o..oo....oo...oo....o...o.........o........oo.oooo.........o.......oo..o....o..o.....o..o..
.......oo.....o...o.......oo..oo....ooo.....ooo..oo..........o......o.o.....o.....o........oo.o.....
........o....o......o......oo.......o..o..o.oo.o.....o.o.....o..........o.o......o..........o..o....
...o..oo.....o.......o.......o........o........o...o..oo...ooo.....o....o....o.o..o.....o.......oo..
....o.......o...oo.....o.o..ooo.....................o.....oo............oo..o.......o.o..o.o.o.o.o..
o....o..oo.....ooo..............o...oo.....ooo..o...oo..o......o.......o..o..o...o.......o.o.o..o..o
......oo.....o..oo....o.o.....o...o...o.o..oo......o.o..o..oo...o...o......o..o.....o......o...o...o
o..o..o..o.........o..o...........o.....o..o...........o.o...o.oo....ooo........oo..o..oo.o.o.o..o..
....o......o...o.oo...o.oo.o.....o......o...........o..o...................o.o.oo..........o..o..o.o
..o.oo......o.....o.......oo.o..o.o...o..o.......o.......o.o..oo.o..o.ooo..o.oo.o.o...o.......o..o..
....o..o.o....oo....o............o....o...o.o....o....o..o..oooo...o.o......o.....o.................
.o........o..........o.o......o.o...o...........o...o.....o.o...o.o.o..o.o....o.o...o......o.o......
.o..oo...o.......o.......o..o.........o..o..o.oo.o.o.o..o...oo.....oo.oo..o..o.o.o....oo.o..o.o.....
.o.....o..o.......o...o...o.....oo......o.o...o....o.o...o............o.....o....o.....o...o........
.......oo..o.o.o..o..o......oo..oooo............ooo..o...o...o.oo...o.oo..o.o..o..o.....oo.o.o......
..............oo..o...o..o..o................o..ooo...............o..o...o............o.......ooo.o.
...o..o....o........o......o.oo..o...o...oo.......o.o....o.o.......o..o....oo.............o...o.o.o.
...o.o.o.o..............ooo..o.o.....o.......o....oo.o...ooooo.o..o.o.o.o.................o......oo.
..........o..o.....o...o.................o....oo.o.....o......oo...........o.............o.o......o.
o....o..........o..o......o.o.o.o...o.o..o.oo.....o.......o.o...o.o.o.o......o.o...o..o.oo......o...
......oo.o.......o.....o...oo.......o............oo..o.o........oo...o..o............ooo.o.......o..
..........oo..o..o.o..........o..o............o........o............o.....oooo.ooo.o......o.....o.o.
.oo....o..o.o....o..oo......o..........o........o......o......o.oo.......o.....o.....o..oo..oo......
.o.o.....oooo.....oo.......oo.o.o.....o..........o.........o.....oo.o......oooooooo.o..o..oo..o.o..o
..o.oo.o....ooo...oo.oo...........ooo.o..oo....o..oo...o............o.ooo.oo..o.....o.....o..o......
....ooo..............o...o.......o..o..o....o.....oo..o..oo.oo....o.........o.o..o............o.....
o.....oo..o.o...oo..o.o....o.oo......o....o.....o.o...o......o..........oo.....o...o........o..ooo..
.o......oo.....oo.........o.....o..oooo.o.....o.....oo.oo............o..........o...oooo..oo....o.o.
..o...oo..o......ooo...o...oo.o....o..o.oo....o.o..o...o....o.......o..o.......o.oo...o.....o....oo.
..............o......o.o.........o.....o....o.....o.o..o.o.............oo...o...oo.........o....o...
.o.o.....o....o.oo.....oo.o........o.....o.o..........oo.......o.....o...oo.o...oo..o......oo..o...o
o..ooo..o.....o..o.o......o.....o.......o......oo..o..o....oo.......o.....o....o..o.......oo........
ooooo.o...o....o....o.o......o.........o..ooo.oo..........oo.....o.o..o......oo....o..........o.....
o.............o...o......oo.....o..o..o..o.....o..o..o..................oo.o.ooo........o.......o...
...o.o.o.oo....o...o.o.....o........o.o.o......o.........oo.oo.o...o..o.o......ooo.....o...oooo.oo..
o...o.o....o..o......o.....o..o...o..........o.o..........o..o........o..........o............o..o..
.oo.ooo..........o.......oo...o..oo....o....o............o........o..o...oo.o.......oo...oo.o.......
...ooo....o.oo..o.o...oo.....o.oooo.oo..oo..o.o.o.o.o.....o......o..........o...o.....oooooo.o....o.
o....o.......o..............o.oo.o.o..oo...o....o....o......o....o.o.oo.........o...o........oo.o...
...o...........oo.....o........oo..o.o.......o.....o....o.....oo............o....o..o..o...o.o....oo
........o....oo...oo....o.oo.o.oo.ooo..o...o..o.o.oo.........o...........o............o...o..o...o..
..oo........o.........o..o.......o.o...o.......o..............o..o..o....o.....o..o.oo.oo.o....oo...
o........o.o..o....oo....o...o.....o.....o....o......o....oo......o....o......o.o...oo........o..o.o
....o.......o.o.......o....o..ooo..o..o....o..oo..o..o.oo.........o......oo...o..o..o.....o.....o.o.
...o.o.o..ooo....o.o...oo.o.....o...o.o...o....oo.....o.o...........oo.o.......oo..oo...o........oo.
....o..o......o.....o...o...o.o....o...oo..o.oo....oo..o.oo.o....o.oo.....o..oo..oo...oo......oo...o
.......oo.o...oo..o.o..o.o......o...............o..ooo.....oo......o.o.....o.o...............o..o...
...............o.......o....o..........oo......o.o...........o..o..o.........o.o...oo.o...o.........
.o.o......o...o........ooo...ooo.o....o.oo....o..oo.....o......o.o.....oo....o......o.o.o.......o.o.
oo.oo..oo................o.......oo.o...o.........o.o...........o....o..o..o.......o..o....o....o...
o...oo........o....oo.oo..o...o.oo.o..o.....o....o..o..oo............o..o..o...o.oooo..........o..o.
...o..o...oo.......o...........o.o............o...o.oo.o...oo...o...o.....o.o..ooo...o.o..o.o..ooo..
..o.o..o.oo......oo......oo.o..o.o...oo.o.o.o.o.o.......o..o.oo.o.....o....ooo...o...........oo..oo.
...o.o..o.o...o..o..o...o.oo..o..o..oo.oo....oo...o.o......o.....o.o.o..o..o.o.o.............o..o...
.....oo.o..o........o...........o.o....oo.o..o..oo.....o.....o..o...oo....o........o....oo..o..oo...
.......o..o....o....oo.......o.......o.....o....o.o.o..........o.o...oo..........o...o......o......o
..o....o...oo....o.......o..o..o.....o.......o..oo.o....o..o.....o.o.oo....o.o.............o......o.
o.oo.....o..o..o.o...............o..........o......o..o..o.............o.....o..........oo...o..oooo
..o.....o.o....o....o..o...oo......o..........o..o..............o..........o.oo.oo.........o.o....oo
o......o.o..o...o...oo....o...o..o.....oo..oo...oo.....o..........ooo.oo....o...o...o.oo............
.....o....o..o..o...........o..oo.o..............o.o.....oo.........o...oo....o.....o..o.....o...o.o
..............o.....o....o..o......o....o..o......ooo.......oo.o...o..o.oo..o.........o..o.o........
o.....o.....o...o..o...o.....oo........o.....o.o...o.oooo....o..o.....oo....o....o........oo.....o..
..o....o......o.o.o.o...oo...oo.o....oo.....oo.o......o.................o.......o.......oo..o.......
..........o.........o..o.o..o..o.......o..o.o..o..........o.o........o...o.....ooo..o......o...o....
....o.oo.o..o..o.o............o..o....o..ooo..o..o...oo.............o.o...o....................oo...
......o..o...o..o............oo..o..oo.....o......................o.ooo.......ooo..........o......oo
oo.o......oo...o..oo..........o..........o..o..ooo...oooo....oo.....o.......o..oo.oo..o.o.......o...
o...o...o........................o.....o..o........o.o...oo.o.....o.o.o..o.o.....o........o.....o..o
...oo............o.o..ooo..o..o....ooo..o.o......o.oo....o..........o..oo..o......o.o......o.o..oo..
oo...o..ooo........oo..............o..o.o.o.o.....o...o..o....o.o....................o...o...ooo.o..
.........o.o...oo...oo.o......o.......o............o.......o....o......o......oo...o..........o.oo.o
....o..ooo..ooo..oo.o....o.............oo......o.o..o...o....o.oo...o........o.o..o.......o..o......
.o.......o.o.............oo.....o....o......o..o....o...o.o...o..o.................o......ooooo...o.
